# # # # # # # # # # # # # # # # # # # # # # # # # # # # # # # #
#                                             .:::::          #
#  +--------+:::::::.    .::::::.     .:::::::::  +--------+  #
#  | SCHOOL |      ':::::::'   '::::::::'         | MARKET |  #
#  +--------+::.                           .::::::+--------+  #
#	 ::       ::.                       .:::'            ::   #
#	 ::.        ::...                 :::'               ::   #
#     ::.          ''':::+----------+::'                .::   #
#      ::.               |          |                  .::    #
#       ::.              +----------+                  ::.    #
#        :::.                  ::.                      ::    #
#          '::::::::.            ::.                   .:'    #
#                  +------+      ::.                 ::'      #
#                  | FARM |       ::.             .::'        #
#                  +------+:::.     ::           .::          #
#                             '::+-------+      ::::          #
#                                | FIELD |:::::::'            #
#                                +-------+                    #
# # # # # # # # # # # # # # # # # # # # # # # # # # # # # # # #